VVVVVVVV
VVVVVVVV
EVVVVVVV
RRGGRVVV
GGGGRRRR
GGGGGGG$
RRRRRRRR
RRRRRRRR