VVVEVVVV
VVGGGVVV
VVVVVVVV
VVVVVVVV
VVVVVVVV
VVVVVVVV
VVVVVVVV
VVVVVVV$