VVVVVVVV
VVVVVVVV
EVVVVVVV
VGGGVVVV
GGGGGVVV
GGGGGGG$
RRRRRRRR
RRRRRRRR