VVVEVVVV
VVRRRVVV
VVVVVVVV
VVVVVVVV
VVVVVVVV
VVVVVVVV
VVVVVVVV
VVVVVV$V