VVVVVVVV
VVEVVVVV
VVGGGVVV
VGGGGGVV
GGGGGGGG
$GGGVGGG
RRRRRRRR
RRRRRRRR