VVVVVVVV
VVEVVVVV
VVGGGVVV
VGGGGGVV
GGGGGGGG
GGGG$GGG
RRRRRRRR
RRRRRRRR