VVVEVVVV
VVRRRVVV
VVCCCVVV
VVVVVVVV
VVVVVVVV
VVVVVVVV
VVVVVVVV
VVVVVV$V