VVVVEVVV
GGGVGVVV
VVVVVVVV
VVVGGGGG
VVVGGGGG
GGVVVVVV
$VVVVVVV
RRRRRRRR