EVVVVVVV
GGGVVVVV
VVVVVVVV
VVVGGGGG
VVVGGGGG
GGVVVVVV
VVVV$VVV
RRRRRRRR