GEGVVVVV
GGGVVVVV
VVVVVVVV
VVVVVVVV
VVVGGVVV
VVVVVVVV
VVVVVVVV
VV$VVVVV