GEGVVVVV
GGGVVVVV
VVVVVVVV
VVVVVVVV
VVGGGVVV
VVVVVVVV
VVVVVVVV
VV$VVVVV