EVVVVVVV
GGGVVVVV
VVVVVVVV
VVVVVVVV
VVVVVVVV
VVVVVVVV
VVVVVVVV
VVVVV$VV