EVVVVVVV
GGGVVVVV
VVRRVVV$
VVVGGGGG
RRVGGGGG
GGVVVVVV
VVVVVVVV
RRRRRRRR