VVVVRVVV
GGVERVVV
VRRRRVVV
VVVGGGGV
RRRGGGGG
GGVVVVVV
VV$VVVVV
RRRRRRRR