VVVVVVVV
VVVVVVVV
VVVVVVVV
VVVVVVVV
RRRRRRRR
GEVVVV$G
RRRRRRRR
RRRRRRRR