VVVVVVVV
VVVVVVVV
VVVVVVVV
VVVVVVVV
ERRRRRRR
GGGGGGG$
RRRRRRRR
RRRRRRRR