VVVVVVVV
VVVVVVVV
VVVVVVVV
VVVVVVVV
RRRRRRRR
G$GGGGEG
RRRRRRRR
RRRRRRRR