VVVVVVVV
VVVVVVVV
VVVVVVVV
VVVVVVVV
RRRRRRRR
G$VVVVEG
RRRRRRRR
RRRRRRRR