VVVVVVVV
VVVVVVVV
VVVVVVVV
VVVVVVVV
EGGGGGGG
GGGGGGG$
RRRRRRRR
RRRRRRRR