8
-
VVVVVVVV
VVVVVVVV
EVVVVVVV
CCCVVVVV
CCCCCVVV  
CCCCCCC$
RRRRRRRR
RRRRRRRR
-
VVVVVVVV
VVEVVVVV
VVCCCVVV
VCCCCCVV
CCCCCCCC
CCCC$CCC
RRRRRRRR
RRRRRRRR
-
EVVVVVVV
CCCVVVVV
VVVVVVVV
VVVCCCCC
VVVCCCCC
CCVVVVVV
VVVV$VVV
RRRRRRRR
-
EVVVVVVV
CCCVVVVV
VVVVVVVV
VVVVVVVV
VVVVVVVV
VVVVVVVV
VVVVVVVV
VVVVV$VV